1|10|1|1
2|10|1|2
3|10|1|3
4|10|1|4
5|10|1|5